11111111111111111111
100000C0000000000001
10111111111111111001
10C000000000C0001001
10111110001111111001
10000010000100001001
10111011110101111001
10001000000100001001
10001111110111111001
100C00000E0000000001
11111111111111111001
1000000000C000000001
10011111111111111001
10P00000000000000001
11111111111111111111