1111111111
100C000101
1011111011
100P011001
111001C011
111001C011
1010010001
10C001E001
1000000001
1111111111
