111111111111111
100000000000001
101111111111101
10C000C00000101
100011111110001
101001000011101
100E01000010001
10C001100001001
100001P00000001
100111110111001
1000000C0000001
111111111111111
