1111111111111111111111111
100000000C000000000000001
1011111111111111111111101
100000000000000C000000001
1001111000000111111111111
1000000010000100000000001
1011111011111101111111101
10C0000000000000000000101
100000C000000000C00000001
1000111111000111111111101
101000010001010000000E001
1010000111010101111111111
10C001000001C000000000001
1000001111011111111111101
1001111000010000000000101
1000100000C001C0000000001
10P0000000000000000000001
1111111111111111111111111
